00000000000000000
01010111111011110
01110101001110010
00101111000000110
00101011111110110
00101010100010100
01101010001010100
*1011010111110110
01110111101001110
00100100001101000
01111111111001110
00000000000000#00